6 9
TTTTTTTTT
TT+..+.+T
T.TTT~TTT
T.TTTR.xT
T*..L...T
TTTTTTTTT