TTTTTTTTT
TT.T.+.+T
T+.TT~TTT
TTTTTR.xT
T...L..*T
TTTTTTTTT