5 9
TTTTTTTTT
T..T.+..T
TL.T.+..T
T....+..T
TTTTTTTTT