TTTTTTTTT
TT.T.+.+T
T+.T.~TTT
TTRTTR.+T
T...L...T
TTTTTTTTT