30 30
TTTTTTTTTTTTTTTTTTTTTTTTTTTTTT
T++TTTTLRTTTTTTT.TRRR.RTTTTTTT
T+TT..........TT.T.T.........T
TTT...........TT.T.T....TTTT.T
TTTTT...RTTTTTT..T.T.......T.T
TT...T*.....TT...T.TTT..TTTT.T
TT....TT...TT....T.T.T....T..T
TTT...TT..TT.....T.TTT...T...T
T.TTTT...TT......T......T....T
T................T...........T
T................TTTTTTTTTTTTT
T............................T
T............................T
T............................T
T............................T
T............................T
T............................T
T............................T
T............................T
T............................T
T............................T
T............................T
T............................T
T............................T
T............................T
T............................T
T............................T
T............................T
T............................T
TTTTTTTTTTTTTTTTTTTTTTTTTTTTTT