TTTTTTTTT
T..T.+..T
TLxT.+..T
T*...+R~T
TTTTTTTTT