TTTTTTTTT
T..T.+..T
TLxT.+..T
T*...+..T
TTTTTTTTT