5 9
TTTTTTTTT
T.RR.+..T
TLxT.+..T
T*...+R~T
TTTTTTTTT