TTTTTTTTT
T.R.~.T.T
T.T.LTT.T
T.x.+.*.T
TTTTTTTTT