TTTTTTTTTTTTT
T....T......T
T.....TTT...T
T..L*.T+T...T
T.....TTTT..T
T....T....T.T
TTTTTTTTTTTTT