TTTTTTTTTTTTTTT
T.L.R...RTT.x.T
TRTTTT..R+~~TTT
T+T..~....T...T
TRT.T...T..R..T
T.x.~...T.....T
TTTTTTTTTTTTTTT